1111111111111111111111111111111111111111
1000000000000000000100000000000000000001
1000200000000000000100000000000000000001
1000000000000000000100000000000000300001
1111111111100000000100000000000000000004
1000000000000000000100000000100000000004
1000000000000000300100000000100000000004
1000000000000000000100000000100000000004
1000000000000000000100000000100000000004
1000000100000000000100000000100000000001
1000000100000000000111111111100000000001
1000000100000000000001000000000000000001
1000000100000000000001000000000000000001
1000000100300000000001000000000000000001
1000000100000010000001000000000000000001
1000000100000010000001000000111111111111
1000200100000010000001000000000000000001
1000000100000010000001000000000000000001
1000000100000010000001000000000000000001
1111111100000010000001000000000100000001
1000000000000010000000000000000100000001
1000000000000010000000000000000100000001
1000000000000010000000000003000100000001
1000000000000010000000000000000100000001
1000000100000011111111110000000100000001
1000000100000000000000010000000100000001
1000000100000000000000010000000100020001
1000000100000000000000010000000100000001
1000000100000000000000010000000100000001
1111111155555111111111111111111111111111