1110111111111111111111111111111111111111
1000000000000030000000000000000000000001
1000000000000000000000000000000000000001
1111111111110000011111111111111111111111
1000000000010000010010003000100000000004
1111111111110000000010000000100000000004
1000000000010000000010000000100000000004
1000000000011000000110000000000000000004
1000000000000000000000000000000000000004
1000000000000000000000000011111111111111
1111110000000001110000000010000000000001
1030000000000001000000000000000000000001
1000111100000001000000000000000000000001
1000000000000001000000002000111111111111
1000000000000001111111111111100300000001
1000000000000001003000030000000000000001
1000111000111111000000000000000000000001
1010000000000000000000000000000000000001
1000000000000000000000000001100000111111
1000000011111110000000000001000000010000
1000000010000010000000000001000000010000
1000000010000010000000000001000000010000
1000111110000011111111111111000000010000
1000000000000000000000000000000000111111
1003000000000000000000000000000000000001
1000000000000111111111111111100011111111
1000000100000100000000000000000001000001
1002000100000102000000000000000001000001
1000000100000100000000000000000000000001
1111111155555111111111111111111111111111